1133    -478 1
1535    -135 2
1876    -291 2
2457    -130 1
2850    -496 1
3197    -312 3
3652    -539 2
4020    -163 2
4374    -298 1
4671    -493 3
5016    -299 1
5503    -140 2
6196    -295 1
6835    -440 3
7282    -210 2
7818    -349 1 
8198    -498 3
8529    -188 1
8905    -310 1
9260    -444 2
9675    -270 2
10174   -150 3
10591   -307 2 
11021   -489 1
11652   -389 3
12165   -273 1
12638   -389 2
13110   -236 2
13494   -435 1
13911   -317 3
14355   -486 2
